-1 -1 -1 -1 -1 -1
-1 -1  5 -1 -1 -1
-1  7  4  2  1 -1
-1 -1  6  3 -1 -1
-1 -1 -1 -1 -1 -1